"acama	[CAT=nc,G=f,N=s]"
"acato	[CAT=nc,G=m,N=s]"
"acre	[CAT=adj,N=s,G=_]"
"afogo	[CAT=nc,G=m,N=s]"
"afro	[CAT=adj,N=s,G=m]"
"agre	[CAT=adj,N=s,G=_]"
"agror	[CAT=nc,G=m,N=s]"
"alojo	[CAT=nc,G=m,N=s]"
"alter	[CAT=nc,G=m,N=s]"
"âmbar	[CAT=nc,G=m,N=s]"
"ameba	[CAT=nc,G=f,N=s]"
"ameia	[CAT=nc,G=f,N=s]"
"amiba	[CAT=nc,G=f,N=s]"
"amojo	[CAT=nc,G=m,N=s]"
"amura	[CAT=nc,G=f,N=s]"
"anafe	[CAT=nc,G=m,N=s]"
"angra	[CAT=nc,G=f,N=s]"
"aorta	[CAT=nc,G=f,N=s]"
"apaga	[CAT=nc,G=f,N=s]"
"apego	[CAT=nc,G=m,N=s]"
"ápice	[CAT=nc,G=m,N=s]"
"arada	[CAT=nc,G=f,N=s]"
"arcaz	[CAT=nc,G=m,N=s]"
"arejo	[CAT=nc,G=m,N=s]"
"árgon	[CAT=nc,G=m,N=s]"
"asada	[CAT=nc,G=f,N=s]"
"ataca	[CAT=nc,G=f,N=s]"
"atada	[CAT=nc,G=f,N=s]"
"atiça	[CAT=nc,G=m,N=s]"
"atino	[CAT=nc,G=m,N=s]"
"atlas	[CAT=nc,G=m,N=s]"
"atroo	[CAT=nc,G=m,N=s]"
"aveia	[CAT=nc,G=f,N=s]"
"azoto	[CAT=nc,G=m,N=s]"
"babel	[CAT=nc,G=f,N=s]"
"baeta	[CAT=nc,G=f,N=s]"
"bafio	[CAT=nc,G=m,N=s]"
"baila	[CAT=nc,G=f,N=s]"
"baixa	[CAT=nc,G=f,N=s]"
"banzé	[CAT=nc,G=m,N=s]"
"baque	[CAT=nc,G=m,N=s]"
"bária	[CAT=nc,G=f,N=s]"
"basta	[CAT=nc,G=f,N=s]"
"batom	[CAT=nc,G=m,N=s]"
"beiça	[CAT=nc,G=f,N=s]"
"bera	[CAT=adj,N=s,G=m]"
"berra	[CAT=nc,G=f,N=s]"
"betão	[CAT=nc,G=m,N=s]"
"bicha	[CAT=nc,G=f,N=s]"
"bigle	[CAT=nc,G=m,N=s]"
"bílis	[CAT=nc,G=f,N=s]"
"bimba	[CAT=nc,G=f,N=s]"
"birra	[CAT=nc,G=f,N=s]"
"bisca	[CAT=nc,G=f,N=s]"
"bocal	[CAT=nc,G=m,N=s]"
"bócio	[CAT=nc,G=m,N=s]"
"bofes	[CAT=nc,G=m,N=p]"
"bófia	[CAT=nc,G=m,N=s]"
"borda	[CAT=nc,G=f,N=s]"
"boroa	[CAT=nc,G=f,N=s]"
"bouça	[CAT=nc,G=f,N=s]"
"breca	[CAT=nc,G=f,N=s]"
"briol	[CAT=nc,G=m,N=s]"
"brita	[CAT=nc,G=f,N=s]"
"bromo	[CAT=nc,G=m,N=s]"
"buçal	[CAT=nc,G=m,N=s]"
"bucho	[CAT=nc,G=m,N=s]"
"bufão	[CAT=nc,G=m,N=s]"
"bulha	[CAT=nc,G=f,N=s]"
"burel	[CAT=nc,G=m,N=s]"
"burgo	[CAT=nc,G=m,N=s]"
"buril	[CAT=nc,G=m,N=s]"
"burra	[CAT=nc,G=f,N=s]"
"cação	[CAT=nc,G=m,N=s]"
"cacau	[CAT=nc,G=m,N=s]"
"caída	[CAT=nc,G=f,N=s]"
"calça	[CAT=nc,G=f,N=s]"
"calda	[CAT=nc,G=f,N=s]"
"calfe	[CAT=nc,G=m,N=s]"
"calha	[CAT=nc,G=f,N=s]"
"calhe	[CAT=nc,G=f,N=s]"
"calma	[CAT=nc,G=f,N=s]"
"canja	[CAT=nc,G=f,N=s]"
"capão	[CAT=nc,G=m,N=s]"
"capim	[CAT=nc,G=m,N=s]"
"capuz	[CAT=nc,G=m,N=s]"
"caqui	[CAT=nc,G=m,N=s]"
"carão	[CAT=nc,G=m,N=s]"
"cardo	[CAT=nc,G=m,N=s]"
"caril	[CAT=nc,G=m,N=s]"
"cariz	[CAT=nc,G=m,N=s]"
"carpa	[CAT=nc,G=f,N=s]"
"casão	[CAT=nc,G=m,N=s]"
"casca	[CAT=nc,G=f,N=s]"
"caspa	[CAT=nc,G=f,N=s]"
"casta	[CAT=nc,G=f,N=s]"
"catorze	[CAT=card,N=p]"
"ceata	[CAT=nc,G=f,N=s]"
"cegas	[CAT=nc,G=f,N=p]"
"ceifa	[CAT=nc,G=f,N=s]"
"celha	[CAT=nc,G=f,N=s]"
"cerne	[CAT=nc,G=m,N=s]"
"césio	[CAT=nc,G=m,N=s]"
"cetra	[CAT=nc,G=f,N=s]"
"chata	[CAT=nc,G=f,N=s]"
"chavo	[CAT=nc,G=m,N=s]"
"cheta	[CAT=nc,G=f,N=s]"
"chibo	[CAT=nc,G=m,N=s]"
"chila	[CAT=nc,G=f,N=s]"
"china	[CAT=nc,G=_,N=s]"
"chinó	[CAT=nc,G=m,N=s]"
"chora	[CAT=nc,G=f,N=s]"
"chuço	[CAT=nc,G=m,N=s]"
"chulé	[CAT=nc,G=m,N=s]"
"cidra	[CAT=nc,G=f,N=s]"
"cinta	[CAT=nc,G=f,N=s]"
"citro	[CAT=nc,G=m,N=s]"
"cloro	[CAT=nc,G=m,N=s]"
"coada	[CAT=nc,G=f,N=s]"
"coaxo	[CAT=nc,G=m,N=s]"
"cobra	[CAT=nc,G=f,N=s]"
"cobre	[CAT=nc,G=m,N=s]"
"cobro	[CAT=nc,G=m,N=s]"
"cocho	[CAT=nc,G=m,N=s]"
"cólon	[CAT=nc,G=m,N=s]"
"comer	[CAT=nc,G=m,N=s]"
"conga	[CAT=nc,G=f,N=s]"
"copas	[CAT=nc,G=f,N=p]"
"copra	[CAT=nc,G=f,N=s]"
"corja	[CAT=nc,G=f,N=s]"
"corta	[CAT=nc,G=f,N=s]"
"cotão	[CAT=nc,G=m,N=s]"
"cousa	[CAT=nc,G=f,N=s]"
"coval	[CAT=nc,G=m,N=s]"
"covão	[CAT=nc,G=m,N=s]"
"coxão	[CAT=nc,G=m,N=s]"
"coxia	[CAT=nc,G=f,N=s]"
"crase	[CAT=nc,G=f,N=s]"
"crude	[CAT=nc,G=m,N=s]"
"cueca	[CAT=nc,G=f,N=s]"
"cunha	[CAT=nc,G=f,N=s]"
"cunho	[CAT=nc,G=m,N=s]"
"cúria	[CAT=nc,G=f,N=s]"
"curie	[CAT=nc,G=f,N=s]"
"curro	[CAT=nc,G=m,N=s]"
"curva	[CAT=nc,G=f,N=s]"
"cuspe	[CAT=nc,G=m,N=s]"
"cuspo	[CAT=nc,G=m,N=s]"
"custa	[CAT=nc,G=f,N=s]"
"damas	[CAT=nc,G=f,N=p]"
"decil	[CAT=nc,G=m,N=s]"
"dedão	[CAT=nc,G=m,N=s]"
"deita	[CAT=nc,G=f,N=s]"
"deixa	[CAT=nc,G=f,N=s]"
"derme	[CAT=nc,G=f,N=s]"
"devir	[CAT=nc,G=m,N=s]"
"dezoito	[CAT=card,N=p]"
"diana	[CAT=nc,G=f,N=s]"
"dobra	[CAT=nc,G=f,N=s]"
"ébulo	[CAT=nc,G=m,N=s]"
"édipo	[CAT=nc,G=m,N=s]"
"égide	[CAT=nc,G=f,N=s]"
"espia	[CAT=nc,G=_,N=s]"
estoicamente	[CAT=adv]
"etano	[CAT=nc,G=m,N=s]"
"étimo	[CAT=nc,G=m,N=s]"
"êxodo	[CAT=nc,G=m,N=s]"
"faina	[CAT=nc,G=f,N=s]"
"farad	[CAT=nc,G=m,N=s]"
"faval	[CAT=nc,G=m,N=s]"
"fénix	[CAT=nc,G=f,N=s]"
"fenol	[CAT=nc,G=m,N=s]"
"féria	[CAT=nc,G=f,N=s]"
"fermi	[CAT=nc,G=m,N=s]"
"fezes	[CAT=nc,G=f,N=p]"
"fiada	[CAT=nc,G=f,N=s]"
"fífia	[CAT=nc,G=f,N=s]"
"fisco	[CAT=nc,G=m,N=s]"
"flúor	[CAT=nc,G=m,N=s]"
folgadamente	[CAT=adv]
"folga	[CAT=nc,G=f,N=s]"
"folia	[CAT=nc,G=f,N=s]"
"fonia	[CAT=nc,G=f,N=s]"
forçadamente	[CAT=adv]
"fouce	[CAT=nc,G=f,N=s]"
"frisa	[CAT=nc,G=f,N=s]"
"frita	[CAT=nc,G=f,N=s]"
frivolamente	[CAT=adv]
"fumão	[CAT=nc,G=m,N=s]"
"funda	[CAT=nc,G=f,N=s]"
"gafo	[CAT=adj,N=s,G=_]"
"gajão	[CAT=nc,G=m,N=s]"
"galga	[CAT=nc,G=f,N=s]"
"gálio	[CAT=nc,G=m,N=s]"
"gamão	[CAT=nc,G=m,N=s]"
"garbo	[CAT=nc,G=m,N=s]"
"gauss	[CAT=nc,G=m,N=s]"
"gávea	[CAT=nc,G=f,N=s]"
"gleba	[CAT=nc,G=f,N=s]"
"glote	[CAT=nc,G=f,N=s]"
"gnoma	[CAT=nc,G=f,N=s]"
"gnose	[CAT=nc,G=f,N=s]"
"gorra	[CAT=nc,G=f,N=s]"
"graal	[CAT=nc,G=m,N=s]"
"graxa	[CAT=nc,G=f,N=s]"
"grita	[CAT=nc,G=f,N=s]"
"grude	[CAT=nc,G=f,N=s]"
"guisa	[CAT=nc,G=f,N=s]"
"hasta	[CAT=nc,G=f,N=s]"
"hélio	[CAT=nc,G=m,N=s]"
"henry	[CAT=nc,G=m,N=s]"
heroicamente	[CAT=adv]
"hertz	[CAT=nc,G=m,N=s]"
"hidra	[CAT=nc,G=f,N=s]"
"hindi	[CAT=nc,G=m,N=s]"
"honor	[CAT=nc,G=m,N=s]"
honradamente	[CAT=adv]
"húmus	[CAT=nc,G=m,N=s]"
"ícaro	[CAT=nc,G=m,N=s]"
ignobilmente	[CAT=adv]
"ilhal	[CAT=nc,G=m,N=s]"
ilicitamente	[CAT=adv]
"imago	[CAT=nc,G=m,N=s]"
incivilmente	[CAT=adv]
"índex	[CAT=nc,G=m,N=s]"
ingenuamente	[CAT=adv]
"ingre	[CAT=nc,G=m,N=s]"
"invés	[CAT=nc,G=m,N=s]"
isoladamente	[CAT=adv]
"janta	[CAT=nc,G=f,N=s]"
"jazer	[CAT=nc,G=m,N=s]"
"jogão	[CAT=nc,G=m,N=s]"
"joule	[CAT=nc,G=m,N=s]"
"judas	[CAT=nc,G=m,N=s]"
"lábia	[CAT=nc,G=f,N=s]"
"lacre	[CAT=nc,G=m,N=s]"
"lanha	[CAT=nc,G=f,N=s]"
"lanho	[CAT=nc,G=m,N=s]"
"lápis	[CAT=nc,G=m,N=_]"
"laréu	[CAT=nc,G=m,N=s]"
"larga	[CAT=nc,G=f,N=s]"
"látex	[CAT=nc,G=m,N=s]"
"lato	[CAT=adj,N=s,G=m]"
"lavra	[CAT=nc,G=f,N=s]"
"ledo	[CAT=adj,N=s,G=m]"
"leira	[CAT=nc,G=f,N=s]"
"lenha	[CAT=nc,G=f,N=s]"
"lepra	[CAT=nc,G=f,N=s]"
"lesma	[CAT=nc,G=f,N=s]"
"leste	[CAT=nc,G=m,N=s]"
lexicalmente	[CAT=adv]
"limão	[CAT=nc,G=m,N=s]"
"limpa	[CAT=nc,G=f,N=s]"
"linfa	[CAT=nc,G=f,N=s]"
"lítio	[CAT=nc,G=m,N=s]"
"lobão	[CAT=nc,G=m,N=s]"
"logos	[CAT=nc,G=m,N=s]"
"logro	[CAT=nc,G=m,N=s]"
"loisa	[CAT=nc,G=f,N=s]"
lubricamente	[CAT=adv]
"lúpus	[CAT=nc,G=m,N=s]"
"mação	[CAT=nc,G=m,N=s]"
"macha	[CAT=nc,G=f,N=s]"
"má-fé	[CAT=nc,G=f,N=s]"
"magia	[CAT=nc,G=f,N=s]"
"major	[CAT=nc,G=m,N=s]"
mal-empregado	[CAT=in]
"malta	[CAT=nc,G=f,N=s]"
"malte	[CAT=nc,G=m,N=s]"
"mando	[CAT=nc,G=m,N=s]"
"maser	[CAT=nc,G=m,N=s]"
"mecha	[CAT=nc,G=f,N=s]"
"médão	[CAT=nc,G=m,N=s]"
"média	[CAT=nc,G=f,N=s]"
"medra	[CAT=nc,G=f,N=s]"
"meias	[CAT=nc,G=f,N=p]"
"menta	[CAT=nc,G=f,N=s]"
"mercê	[CAT=nc,G=f,N=s]"
"miada	[CAT=nc,G=f,N=s]"
"miado	[CAT=nc,G=m,N=s]"
"micra	[CAT=nc,G=f,N=s]"
"migas	[CAT=nc,G=f,N=p]"
"minga	[CAT=nc,G=f,N=s]"
"mirra	[CAT=nc,G=f,N=s]"
"mitra	[CAT=nc,G=f,N=s]"
"monhé	[CAT=nc,G=m,N=s]"
"monta	[CAT=nc,G=f,N=s]"
"mossa	[CAT=nc,G=f,N=s]"
"mosto	[CAT=nc,G=m,N=s]"
"moura	[CAT=nc,G=f,N=s]"
"mudez	[CAT=nc,G=f,N=s]"
"nabal	[CAT=nc,G=m,N=s]"
"nafta	[CAT=nc,G=f,N=s]"
"nano	[CAT=adj,N=s,G=m]"
"natal	[CAT=nc,G=m,N=s]"
"neuro	[CAT=nc,G=m,N=s]"
"nimbo	[CAT=nc,G=m,N=s]"
"noema	[CAT=nc,G=m,N=s]"
"noese	[CAT=nc,G=f,N=s]"
nomeadamente	[CAT=adv]
"noventa	[CAT=card,N=p]"
"nudez	[CAT=nc,G=f,N=s]"
"oásis	[CAT=nc,G=m,N=s]"
"óbice	[CAT=nc,G=m,N=s]"
obliquamente	[CAT=adv]
"ocaso	[CAT=nc,G=m,N=s]"
"oeste	[CAT=nc,G=m,N=s]"
"ofego	[CAT=nc,G=m,N=s]"
"oídio	[CAT=nc,G=m,N=s]"
"oirar	[CAT=nc,G=f,N=s]"
"oitenta	[CAT=card,N=p]"
"olhal	[CAT=nc,G=m,N=s]"
"oliva	[CAT=nc,G=f,N=s]"
"ómega	[CAT=nc,G=m,N=s]"
"orada	[CAT=nc,G=f,N=s]"
"óveo	[CAT=adj,N=s,G=m]"
"ozone	[CAT=nc,G=m,N=s]"
"ozono	[CAT=nc,G=m,N=s]"
"panda	[CAT=nc,G=f,N=s]"
"papão	[CAT=nc,G=m,N=s]"
"papas	[CAT=nc,G=f,N=p]"
"parla	[CAT=nc,G=f,N=s]"
"parra	[CAT=nc,G=f,N=s]"
"pasmo	[CAT=nc,G=m,N=s]"
"patão	[CAT=nc,G=m,N=s]"
pausadamente	[CAT=adv]
"pavio	[CAT=nc,G=m,N=s]"
"pavoa	[CAT=nc,G=f,N=s]"
"pecha	[CAT=nc,G=f,N=s]"
"pelém	[CAT=nc,G=m,N=s]"
"pelve	[CAT=nc,G=f,N=s]"
"penha	[CAT=nc,G=f,N=s]"
"pénis	[CAT=nc,G=m,N=s]"
"peral	[CAT=nc,G=m,N=s]"
perdidamente	[CAT=adv]
perfidamente	[CAT=adv]
"pesca	[CAT=nc,G=f,N=s]"
pessimamente	[CAT=adv]
"piche	[CAT=nc,G=m,N=s]"
"pilão	[CAT=nc,G=m,N=s]"
"pinho	[CAT=nc,G=m,N=s]"
"piora	[CAT=nc,G=f,N=s]"
"pique	[CAT=nc,G=m,N=s]"
"pitão	[CAT=nc,G=m,N=s]"
"pitéu	[CAT=nc,G=m,N=s]"
placidamente	[CAT=adv]
"plana	[CAT=nc,G=f,N=s]"
"plebe	[CAT=nc,G=f,N=s]"
"podão	[CAT=nc,G=m,N=s]"
"pódio	[CAT=nc,G=m,N=s]"
"poisa	[CAT=nc,G=f,N=s]"
"pólen	[CAT=nc,G=m,N=s]"
"pomba	[CAT=nc,G=f,N=s]"
"pomes	[CAT=nc,G=m,N=s]"
"porca	[CAT=nc,G=f,N=s]"
"porte	[CAT=nc,G=m,N=s]"
postumamente	[CAT=adv]
"potra	[CAT=nc,G=f,N=s]"
"presa	[CAT=nc,G=f,N=s]"
prodigamente	[CAT=adv]
"pro	[CAT=a_nc,N=s,G=_]"
"prole	[CAT=nc,G=f,N=s]"
propriamente	[CAT=adv]
proximamente	[CAT=adv]
"prumo	[CAT=nc,G=m,N=s]"
"púbis	[CAT=nc,G=f,N=s]"
publicamente	[CAT=adv]
"purga	[CAT=nc,G=f,N=s]"
"queda	[CAT=nc,G=f,N=s]"
quimicamente	[CAT=adv]
"quita	[CAT=nc,G=f,N=s]"
"racha	[CAT=nc,G=f,N=s]"
"rádon	[CAT=nc,G=m,N=s]"
"ráfia	[CAT=nc,G=f,N=s]"
"raiva	[CAT=nc,G=f,N=s]"
"ralho	[CAT=nc,G=m,N=s]"
"ranho	[CAT=nc,G=m,N=s]"
"raspa	[CAT=nc,G=f,N=s]"
"redor	[CAT=nc,G=m,N=s]"
"régie	[CAT=nc,G=f,N=s]"
regradamente	[CAT=adv]
"relva	[CAT=nc,G=f,N=s]"
"repto	[CAT=nc,G=m,N=s]"
"retém	[CAT=nc,G=m,N=s]"
"reuma	[CAT=nc,G=f,N=s]"
"rezão	[CAT=nc,G=m,N=s]"
"rifle	[CAT=nc,G=m,N=s]"
"rijão	[CAT=nc,G=m,N=s]"
"risca	[CAT=nc,G=f,N=s]"
ritmicamente	[CAT=adv]
"rolão	[CAT=nc,G=m,N=s]"
"ronca	[CAT=nc,G=f,N=s]"
"roque	[CAT=nc,G=m,N=s]"
"rubor	[CAT=nc,G=m,N=s]"
"rufia	[CAT=nc,G=m,N=s]"
"rugir	[CAT=nc,G=m,N=s]"
"rúpia	[CAT=nc,G=f,N=s]"
"rusga	[CAT=nc,G=f,N=s]"
"saber	[CAT=nc,G=m,N=s]"
"sabiá	[CAT=nc,G=m,N=s]"
"sacho	[CAT=nc,G=m,N=s]"
"salva	[CAT=nc,G=f,N=s]"
"sanca	[CAT=nc,G=f,N=s]"
"sanha	[CAT=nc,G=f,N=s]"
"saqué	[CAT=nc,G=m,N=s]"
"sarja	[CAT=nc,G=f,N=s]"
"sarna	[CAT=nc,G=f,N=s]"
"sarro	[CAT=nc,G=m,N=s]"
"saúde	[CAT=nc,G=f,N=s]"
"seiva	[CAT=nc,G=f,N=s]"
"sêmea	[CAT=nc,G=f,N=s]"
"sémen	[CAT=nc,G=m,N=s]"
serodiamente	[CAT=adv]
"serpe	[CAT=nc,G=f,N=s]"
"setenta	[CAT=card,N=p]"
"sexta	[CAT=nc,G=f,N=s]"
"sidra	[CAT=nc,G=f,N=s]"
"sigma	[CAT=nc,G=m,N=s]"
"sílex	[CAT=nc,G=m,N=s]"
"sinhá	[CAT=nc,G=f,N=s]"
"sirga	[CAT=nc,G=f,N=s]"
"sobra	[CAT=nc,G=f,N=s]"
sobremaneira	[CAT=adv]
"sódio	[CAT=nc,G=m,N=s]"
"solda	[CAT=nc,G=f,N=s]"
"solta	[CAT=nc,G=f,N=s]"
"sorna	[CAT=nc,G=f,N=s]"
"sóror	[CAT=nc,G=f,N=s]"
"sorvo	[CAT=nc,G=m,N=s]"
"sueca	[CAT=nc,G=f,N=s]"
"surro	[CAT=nc,G=m,N=s]"
"tacha	[CAT=nc,G=f,N=s]"
"taipa	[CAT=nc,G=f,N=s]"
"talco	[CAT=nc,G=m,N=s]"
"talha	[CAT=nc,G=f,N=s]"
"tanas	[CAT=nc,G=m,N=s]"
"tarja	[CAT=nc,G=f,N=s]"
tecnicamente	[CAT=adv]
"ténis	[CAT=nc,G=m,N=s]"
"tensa	[CAT=nc,G=f,N=s]"
"tesão	[CAT=nc,G=m,N=s]"
"tétum	[CAT=nc,G=m,N=s]"
"tição	[CAT=nc,G=m,N=s]"
"tinga	[CAT=nc,G=f,N=s]"
"tinha	[CAT=nc,G=f,N=s]"
"toada	[CAT=nc,G=f,N=s]"
"tolda	[CAT=nc,G=f,N=s]"
"tolde	[CAT=nc,G=m,N=s]"
"tórax	[CAT=nc,G=m,N=s]"
"torga	[CAT=nc,G=f,N=s]"
"tório	[CAT=nc,G=m,N=s]"
"trato	[CAT=nc,G=m,N=s]"
"trava	[CAT=nc,G=f,N=s]"
"trave	[CAT=nc,G=f,N=s]"
"travo	[CAT=nc,G=m,N=s]"
"trepa	[CAT=nc,G=f,N=s]"
"tricô	[CAT=nc,G=m,N=s]"
"troça	[CAT=nc,G=f,N=s]"
"trufa	[CAT=nc,G=f,N=s]"
"trupe	[CAT=nc,G=f,N=s]"
"tumba	[CAT=nc,G=_,N=s]"
"turba	[CAT=nc,G=f,N=s]"
"turfa	[CAT=nc,G=f,N=s]"
unanimemente	[CAT=adv]
univocamente	[CAT=adv]
"ureia	[CAT=nc,G=f,N=s]"
"urzal	[CAT=nc,G=m,N=s]"
"uvaça	[CAT=nc,G=f,N=s]"
"uval	[CAT=adj,N=s,G=_]"
"vácuo	[CAT=nc,G=m,N=s]"
"valia	[CAT=nc,G=f,N=s]"
"vazão	[CAT=nc,G=f,N=s]"
"veiga	[CAT=nc,G=m,N=s]"
"vigor	[CAT=nc,G=m,N=s]"
"vinda	[CAT=nc,G=f,N=s]"
"vírus	[CAT=nc,G=m,N=p]"
"visco	[CAT=nc,G=m,N=s]"
"vizir	[CAT=nc,G=m,N=s]"
"vólei	[CAT=nc,G=m,N=s]"
"vulgo	[CAT=nc,G=m,N=s]"
"xénon	[CAT=nc,G=m,N=s]"
"xeque	[CAT=nc,G=m,N=s]"
"xerez	[CAT=nc,G=m,N=s]"
"zinco	[CAT=nc,G=m,N=s]"
"zínia	[CAT=nc,G=f,N=s]"
"zomba	[CAT=nc,G=f,N=s]"
"Apple	[CAT=np,G=f,N=s]"
"Intel	[CAT=np,G=f,N=s]"
"pixel	[CAT=nc,G=m,N=s]"
"Abrams	[CAT=np,SEM=p1]"
"Alá	[CAT=np,G=m,SEM=p]"
"Albert	[CAT=np,SEM=p1]"
"Alencar	[CAT=np,SEM=p]"
"Aluísio	[CAT=np,SEM=p]"
"Álvares	[CAT=np,SEM=p]"
"Ana	[CAT=np,G=f,SEM=p]"
"Andrade	[CAT=np,SEM=p]"
"Ângelo	[CAT=np,SEM=p1]"
"Antunes	[CAT=np,SEM=p]"
"Arnold	[CAT=np,SEM=p1]"
"Bacelar	[CAT=np,SEM=p]"
"Balzac	[CAT=np,SEM=p1]"
"Barbosa	[CAT=np,SEM=p]"
"Barreto	[CAT=np,SEM=p]"
"Barroso	[CAT=np,SEM=p]"
"Bartok	[CAT=np,SEM=p1]"
"Becket	[CAT=np,SEM=p1]"
"Beltrão	[CAT=np,SEM=p]"
"Berger	[CAT=np,SEM=p1]"
"Bordalo	[CAT=np,SEM=p]"
"Botelho	[CAT=np,SEM=p]"
"Brahms	[CAT=np,SEM=p1]"
"Brandão	[CAT=np,SEM=p]"
"Brandt	[CAT=np,SEM=p1]"
"Calvin	[CAT=np,SEM=p1]"
"Camacho	[CAT=np,SEM=p]"
"Cardan	[CAT=np,SEM=p1]"
"Cardoso	[CAT=np,SEM=p]"
"Carmona	[CAT=np,SEM=p]"
"Carrol	[CAT=np,SEM=p1]"
"Céu	[CAT=np,G=f,SEM=p]"
"Chaplin	[CAT=np,SEM=p]"
"Charles	[CAT=np,SEM=p]"
"Chopin	[CAT=np,SEM=p1]"
"Claire	[CAT=np,SEM=p1]"
"Claude	[CAT=np,SEM=p1]"
"Clinton	[CAT=np,SEM=p]"
"Colombo	[CAT=np,SEM=p]"
"Connor	[CAT=np,SEM=p1]"
"Conrado	[CAT=np,SEM=p]"
"Correia	[CAT=np,SEM=p]"
"Dalton	[CAT=np,SEM=p1]"
"Damásio	[CAT=np,SEM=p]"
"Darwin	[CAT=np,SEM=p1]"
"Didier	[CAT=np,SEM=p1]"
"Diodoro	[CAT=np,SEM=p]"
"Dumont	[CAT=np,SEM=p1]"
"Eça	[CAT=np,G=m,SEM=p]"
"Edmond	[CAT=np,SEM=p1]"
"Edmund	[CAT=np,SEM=p1]"
"Edmundo	[CAT=np,SEM=p]"
"Edward	[CAT=np,SEM=p1]"
"Engels	[CAT=np,SEM=p1]"
"Epicuro	[CAT=np,SEM=p]"
"Erasmo	[CAT=np,SEM=p1]"
"Evangelho	[CAT=np,G=m]"
"Eva	[CAT=np,G=f,SEM=p]"
"Fermat	[CAT=np,SEM=p1]"
"Filinto	[CAT=np,SEM=p]"
"Fonseca	[CAT=np,SEM=p]"
"Freitas	[CAT=np,SEM=p]"
"Fulton	[CAT=np,SEM=p1]"
"Gal	[CAT=np,G=f,SEM=p]"
"Gál	[CAT=np,G=f,SEM=p]"
"Garrett	[CAT=np,SEM=p]"
"Gaulle	[CAT=np,SEM=p1]"
"George	[CAT=np,SEM=p1]"
"Gil	[CAT=np,G=m,SEM=p]"
"Godard	[CAT=np,SEM=p1]"
"Godinho	[CAT=np,SEM=p]"
"Goethe	[CAT=np,SEM=p1]"
"Gonzaga	[CAT=np,SEM=p]"
"Gordon	[CAT=np,SEM=p1]"
"Górgias	[CAT=np,SEM=p]"
"Gouveia	[CAT=np,SEM=p]"
"Guevara	[CAT=np,SEM=p]"
"Guiomar	[CAT=np,SEM=p]"
"Guliver	[CAT=np,SEM=p]"
"Gustavo	[CAT=np,SEM=p]"
"Handel	[CAT=np,SEM=p1]"
"Harold	[CAT=np,SEM=p1]"
"Herman	[CAT=np,SEM=p1]"
"Hobbes	[CAT=np,SEM=p1]"
"Howard	[CAT=np,SEM=p1]"
"Hubble	[CAT=np,SEM=p1]"
"Hudson	[CAT=np,SEM=p1]"
"Ingmar	[CAT=np,SEM=p1]"
"Irving	[CAT=np,SEM=p1]"
"Ivo	[CAT=np,G=m,SEM=p]"
"Jacobi	[CAT=np,SEM=p1]"
"Jaques	[CAT=np,SEM=p1]"
"Jordan	[CAT=np,SEM=p1]"
"Joseph	[CAT=np,SEM=p1]"
"Judith	[CAT=np,SEM=p1]"
"Julian	[CAT=np,SEM=p1]"
"Julius	[CAT=np,SEM=p1]"
"Keaton	[CAT=np,SEM=p1]"
"Keller	[CAT=np,SEM=p1]"
"Kelvin	[CAT=np,SEM=p1]"
"Kepler	[CAT=np,SEM=p1]"
"Keynes	[CAT=np,SEM=p1]"
"Kleene	[CAT=np,SEM=p1]"
"Lacerda	[CAT=np,SEM=p]"
"Ludwig	[CAT=np,SEM=p1]"
"Luther	[CAT=np,SEM=p1]"
"Luz	[CAT=np,G=f,SEM=p]"
"Machado	[CAT=np,SEM=p]"
"Mandela	[CAT=np,SEM=p]"
"Mao	[CAT=np,G=m,SEM=p]"
"Marcel	[CAT=np,SEM=p1]"
"Marcus	[CAT=np,SEM=p1]"
"Marques	[CAT=np,SEM=p]"
"Martin	[CAT=np,SEM=p1]"
"Martins	[CAT=np,SEM=p]"
"Mendez	[CAT=np,SEM=p1]"
"Meneses	[CAT=np,SEM=p]"
"Menezes	[CAT=np,SEM=p]"
"Milner	[CAT=np,SEM=p1]"
"Milton	[CAT=np,SEM=p1]"
"Minotauro	[CAT=np,G=m]"
"Miranda	[CAT=np,SEM=p]"
"Monroe	[CAT=np,SEM=p1]"
"Moreira	[CAT=np,SEM=p]"
"Morgan	[CAT=np,SEM=p1]"
"Mozart	[CAT=np,SEM=p1]"
"Muller	[CAT=np,SEM=p1]"
"Murphy	[CAT=np,SEM=p1]"
"Nadine	[CAT=np,SEM=p1]"
"Nellie	[CAT=np,SEM=p1]"
"Nemésio	[CAT=np,SEM=p]"
"Newman	[CAT=np,SEM=p1]"
"Nóbrega	[CAT=np,SEM=p]"
"Noé	[CAT=np,G=m,SEM=p]"
"Oliver	[CAT=np,SEM=p1]"
"Ortigão	[CAT=np,SEM=p]"
"Osborn	[CAT=np,SEM=p1]"
"Paiva	[CAT=np,SEM=rio]"
"Palmer	[CAT=np,SEM=p1]"
"Parente	[CAT=np,SEM=p]"
Parnasianismo	[CAT=np]
"Pavlov	[CAT=np,SEM=p1]"
"Pedrosa	[CAT=np,SEM=p]"
"Pedroso	[CAT=np,SEM=p]"
"Peixoto	[CAT=np,SEM=p]"
"Pereira	[CAT=np,SEM=p]"
"Piçarra	[CAT=np,SEM=p]"
"Pierre	[CAT=np,SEM=p1]"
"Pimenta	[CAT=np,SEM=p]"
"Planck	[CAT=np,SEM=p1]"
"Popper	[CAT=np,SEM=p1]"
"Potter	[CAT=np,SEM=p1]"
"Prince	[CAT=np,SEM=p1]"
"Proença	[CAT=np,SEM=p]"
"Proust	[CAT=np,SEM=p1]"
"Queirós	[CAT=np,SEM=p]"
"Queiroz	[CAT=np,SEM=p]"
"Quental	[CAT=np,SEM=p]"
"Quercus	[CAT=np,SEM=p]"
"Rachel	[CAT=np,SEM=p1]"
"Ramalho	[CAT=np,SEM=p]"
"Ramires	[CAT=np,SEM=p]"
"Renoir	[CAT=np,SEM=p1]"
"Resende	[CAT=np,SEM=p]"
"Ribeiro	[CAT=np,SEM=p]"
"Rimski	[CAT=np,SEM=p1]"
"Robert	[CAT=np,SEM=p1]"
"Ródão	[CAT=np,SEM=rio]"
"Rommel	[CAT=np,SEM=p1]"
"Ronaldo	[CAT=np,SEM=p]"
"Rosário	[CAT=np,SEM=p]"
"Rosita	[CAT=np,SEM=p1]"
"Rubens	[CAT=np,SEM=p1]"
"Rui	[CAT=np,G=m,SEM=p]"
"Russel	[CAT=np,SEM=p1]"
"Sanches	[CAT=np,SEM=p]"
"Santana	[CAT=np,SEM=p]"
"Saraiva	[CAT=np,SEM=p]"
"Sartre	[CAT=np,SEM=p1]"
"Seguin	[CAT=np,SEM=p1]"
"Spínola	[CAT=np,SEM=p]"
"Stuart	[CAT=np,SEM=p1]"
"Suárez	[CAT=np,SEM=p1]"
"Tanner	[CAT=np,SEM=p1]"
"Tavares	[CAT=np,SEM=p]"
"Taveira	[CAT=np,SEM=p]"
"Thomas	[CAT=np,SEM=p1]"
"Torcato	[CAT=np,SEM=p]"
Transcaucásia	[CAT=np]
"Trevis	[CAT=np,SEM=p1]"
"Trinitá	[CAT=np,SEM=p]"
"Tsé	[CAT=np,G=m,SEM=p]"
"Turner	[CAT=np,SEM=p1]"
"Valença	[CAT=np,SEM=p]"
"Valério	[CAT=np,SEM=p]"
"Vasques	[CAT=np,SEM=p]"
"Volta	[CAT=np,SEM=rio]"
"Walter	[CAT=np,SEM=p1]"
"Watson	[CAT=np,SEM=p1]"
"Weimar	[CAT=np,SEM=p1]"
"Welles	[CAT=np,SEM=p1]"
"Wilson	[CAT=np,SEM=p1]"
"Xiitas	[CAT=np,SEM=po]"
